Present	Hindi Meaning	Past	Past Participle
===========================================
Buy	खरीदना	Bought	Bought
Build	बांधना	Built	Built
burn	जलना	Burnt	Burnt
Bend	झुकना	Bent	Bent
Bring	लाना	brought	brought
Become	होना	Became	Become
Come	आना	Came	Come
Catch	पकड़ना	Caught	Caught
Do	करना	Did	Done
Dream	ख्वाब देखना	Dreamt	Dreamt
Arise	उठना / जागना	Arose	Arisen
Be	होना	Was, were	Been
Bear	सहन करना	Bore	Bore
Beat	मारना	Beat	Beat
Bite	काटना	Bit	Bitten
Break	तोडना	Broke	Broken
Choose	चुनना	Chose	Chosen
Draw	चित्र बनाना	Drew	Drawn
Drive	चलाना	Drove	Driven
Eat	खाना	Ate	Eaten
Fall	गिरना	Fell	Fallen
Fly	उड़ना	Flew	Flown
Forget	भूल जाना	Forgot	Forgotten
Forgive	माफ़ करना	Forgave	Forgiven
Give	देना	Gave	Given
Grow	बढ़ना	Grew	Grown
Hide	छिपना	Hid	Hidden
Know	जानना	Knew	Knew
Lie	लेटना	Lay	Lain
Ride	सवार होना	Rode	Ridden
Rise	उठना	Rose	Risen
See	देखना	Saw	Seen
Speak	बोलना	Spoke	Spoken
Take	लेना	Took	Taken
Throw	फेकना	Threw	Thrown
Wake	जागना	Woke	Woken
Wear	कपडे पहनना	Wore	Worn
Write	लिखना	Wrote	Written
Begin	शुरू करना	Began	Begun
Drink	पीना	Drank	Drunk
Ring	घंटी बजाना	Rang	Rung
Run	दौड़ना	Ran	Run
Shrink	सिकुड़ना	Shrank	Shrunk
Sing	गाना	Sang	Sung
Sink	डूबना	Sank	Sunk
Swear	कसम लेना	Swore	Sworn
Stand	खड़े रहना	Stood	Stood
Sell	बेंचना	Sold	Sold
Shine	चमकना	Shone	Shone
Shoot	गोली मारना	Shot	Shot
Sit	बैठना	Sat	Sat
Swim	तैरना	Swam	Swum
Sweep	झाडु लगाना	Swept	Swept
Sleep	सोना	Slept	Slept
Steal	चोरी हो जाना	Stole	Stolen
Smell	सूंघना	Smelt	Smelt
Teach	पढ़ाना	Taught	Taught
Tell	कहना	Told	Told
Think	सोचना	Thought	Thought
Understand	समझना	Understood	Understood
Win	जितना	Won	Won
Withdraw	निकालना	Withdrew	Withdrawn
Fight	लढाई करना	Fought	Fought
Feed	खिलाना	Fed	Fed
Feel	महसुस करना	Felt	Felt
Find	ढूंडना	Found	Found
Forbid	रोकना	Forbade	Forbidden
Get	पाना	Got	Got
Go	जाना	Went	Gone
Hear	सुनना	Heard	Heard
Hold	पकड़ना	Held	Held
Hang	टांगना / लटकना	Hung	Hung
Keep	रखना	Kept	Kept
Learn	सीखना	Learnt	Learnt
Leave	छोड़ना	Left	Left
Mean	अर्थ होना	Meant	Meant
Make	बनाना	Made	Made
Overtake	आगे पहुंचना	Overtook	Overtaken
Pay	अदा करना	Paid	Paid
Say	कहना	Said	Said
Bet	दाव  लगाना	Bet	Bet
Bid	बोली लगाना	Bid	Bid
Burst	फूटना	Burst	Burst
Cut	काटना	Cut	Cut
Hit	मारना	Hit	Hit
Hurt	जख्मी करना	Hurt	Hurt
Knit	बुनना	Knit	Knit
Put	रखना	Put	Put
Read	पढना	Read	Read
Set	लगाना	Set	Set
Shut	बंद करना	Shut	Shut
Spread	फैलाना	Spread	Spread
Spit	थूकना	Spit	Spit
Accept	मान्य करना	Accepted	Accepted
Act	अभिनय करना	Acted	Acted
Add	मिलाना/जोड़ना	Added	Added
Admire	प्रशंशा करना	Admired	Admired
Admit	भरती	Admitted	Admitted
Adopt	गोद लेना	Adopted	Adopted
Agree	मानना	Agreed	Agreed
Allow	परवानगी देना	Allowed	Allowed
Announce	जाहिर करना	Announced	Announced
Answer	जवाब देना	Answered	Answered
Apologize	क्षमा मांगना	Apologized	Apologized
Appear	प्रकट होना	Appeared	Appeared
Appoint	नियुक्त करना	Appointed	Appointed
Argue	बहस करना	Argued	Argued
Arrange	व्यवस्तित करना	Arranged	Arranged
Arrest	अटक करना	Arrested	Arrested
Arrive	आगमन होना	Arrived	Arrived
Attach	जोड़ना	Attached	Attached
Attack	आक्रमण करना	Attacked	Attacked
Attempt	प्रयास करना	Attempted	Attempted
Attend	उपस्थित होना	Attended	Attended
Avoid	टालना	Avoided	Avoided
Await	इंतजार करना	Awaited	Awaited
Award	इनाम देना	Awarded	Awarded
Ban	प्रतिबंद करना	banned	Banned
Bargain	भाव करना, मोलतोल करना	Bargained	Bargained
Behave	व्यवहार करना	Behaved	Behaved
Believe	विश्वास रखना	Believed	Believed
Bless	आशीर्वाद देना	Blessed	Blessed
Boil	उबालना	Boiled	Boiled
Build	बांधना	Built	Built
Burn	जलना	Burnt	Burnt
Bury	गाढ़ देना	Buried	Buried
Call	बुलाना	Called	Called
Cancel	रद्द करना	Canceled	Canceled
Care	देखभाल करना	Cared	Cared
Carry	ले जाना	Carried	Carried
Celebrate	मनाना	Celebrated	Celebrated
Challenge	चुनौती देना	Challenged	Challenged
Change	बदलना	Changed	Changed
Cheat	धोकाधडी करना	Cheated	Cheated
Check	जाँच करना	Checked	Checked
Clarify	स्पष्ट करना	Clarified	Clarified
Clean	सफाई करना	Cleaned	Cleaned
Clear	साफ करना	Cleared	Cleared
Climb	चढ़ना	Climbed	Climbed
Close	बंद करना	Closed	Closed
Collect	इक्कठा करना	Collected	Collected
Command	हुकुम चलाना	Commanded	Commanded
Comment	टिपण्णी करना	Commented	Commented
Compare	तुलना करना	Compared	Compared
Complete	पूरा करना	Completed	Completed
Confirm	पुष्टि करना	Confirmed	Confirmed
Connect	जोड़ना	Connected	Connected
Construct	निर्माण करना	Constructed	Constructed
Continue	चालू रखना	Continued	Continued
Control	नियंत्रण करना	Controlled	Controlled
Cook	पकाना	Cooked	Cooked
Copy	नक़ल करना	Copied	Copied
Cure	इलाज करना	Cured	Cured
Dance	नाचना	Danced	Danced
Decide	निर्णय लेना	Decided	Decided
Declare	घोषित करना	Declared	Declared
Decorate	सुशोभित करना	Decorated	Decorated
Defeat	पराजित करना	Defeated	Defeated
Demand	मांग करना	Demanded	Demanded
Depend	आश्रित रहना	Depended	Depended
Describe	वर्णन करना	Described	Described
Desire	इच्छा जताना	Desired	Desired
Dispatch	भेजना	Dispatched	Dispatched
Destroy	नाश करना	Destroyed	Destroyed
Devote	समप्रित करना	Devoted	Devoted
Die	मरना	Died	Died
Disappear	गायब होना	Disappeared	Disappeared
Discuss	चर्चा करना	Discussed	Discussed
Dislike	नापसंद करना	Disliked	Disliked
Distribute	बाँटना	Distributed	Distributed
Divide	विभाजित करना	Divided	Divided
Doubt	शक करना	Doubted	Doubted
Drop	गिराना	Dropped	Dropped
Dry	सुखाना	Dried	Dried
Earn	कमाना	Earned	Earned
Educate	शिक्षित करना	Educated	Educated
Elect	निर्वाजित करना	Elected	Elected
Embrace	गले लगाना	Embraced	Embraced
Employ	नौकरी देना	Employed	Employed
Enjoy	मजा करना	Enjoyed	Enjoyed
Enquire	पूछताछ करना	Enquired	Enquired
Enter	अंदर जाना	Entered	Entered
Establish	स्थापित करना	Established	Established
Excuse	क्षमा करना	Excused	Excused
Exchange	अदलाबदली करना	Exchanged	Exchanged
Expand	विस्तार करना	Expanded	Expanded
Expect	अपेक्षा करना	Expected	Expected
Experience	अनुभव करना	Experienced	Experienced
Explain	समझाना	Explained	Explained
Export	निर्यात करना	Exported	Exported
Extend	बढ़ाना	Extended	Extended
Face	सामना करना	Faced	Faced
Fade	फीका पड़ना	Faded	Faded
Fail	असफल होना	Failed	Failed
Favour	मेहरबानी	Favoured	Favoured
Fear	घबराना	Feared	Feared
Feed	खिलाना	Fed	Fed
Fetch	जाकर लाना	Fetched	Fetched
Fight	लढाई करना	fought	fought
Fill	भरना	Filled	Filled
Find	पाना	Found	Found
Finish	ख़त्म करना	Finished	Finished
Flatter	खुशामद करना	Flattered	Flattered
Follow	अनुसरण करना	Followed	Followed
Force	जबरदस्ती करना	Forced	Forced
Form	बनाना, रूप देना	Formed	Formed
Forward	आगे भेजना	Forwarded	Forwarded
Gain	पाना	Gained	Gained
Gamble	जुआ खेलना	Gambled	Gambled
Generate	उत्पन्न करना	Generated	Generated
Greet	स्वागत करना	Greeted	Greeted
Grumble	बड़बड़ाना	Grumbled	Grumbled
Guard	रक्षा करना	Guarded	Guarded
Guide	मार्ग दिखलाना, मार्गदर्शन करना	Guided	Guided
Halt	पड़ाव डालना, रुकना	Halted	Halted
Handcuff	बेडी ठोकना	Handcuffed	Handcuffed
Handle	नियंत्रण करना	Handled	Handled
Hang	फाँसी देना	Hanged	Hanged
Harass	सताना, तंग करना	Harassed	Harassed
Harm	नुकसान करना	Harmed	Harmed
Help	मदत करना	Helped	Helped
Hire	किराये पर देना, भाड़े पर रखना	Hired	Hired
Hoist	खड़ा करना, उभाड़ना	Hoisted	Hoisted
Honour	सन्मान देना	Honoured	Honoured
Hope	आशा करना	Hoped	Hoped
Hunt	शिकार करना	Hunted	Hunted
Hurry	जल्दबाजी करना	Hurried	Hurried
Identify	पहचानना	Identified	Identified
Ignore	नज़रअंदाज़ करना	Ignored	Ignored
Imagine	कल्पना करना	Imagined	Imagined
Imprison	बंदी बनाना	Imprisoned	Imprisoned
Increase	बढ़ना	Increased	Increased
Indicate	दर्शाना	Indicated	Indicated
Inform	सूचित करना	Informed	Informed
Injure	जख्मी होना	Injured	Injured
Install	स्थापित करना	Installed	Installed
Instruct	निर्देश देना	Instructed	Instructed
Insult	अपमान करना	Insulted	Insulted
Interview	मुलाखत	Interviewed	Interviewed
Introduce	पहचान करवाना	Introduced	Introduced
Invent	खोज करना	Invented	Invented
Invest	निवेश करना	Invested	Invested
Invite	आमंत्रित करना	Invited	Invited
Iron	इस्त्री करना	Ironed	Ironed
Join	जोड़ना	Joined	Joined
Jump	कूदना	Jumped	Jumped
Kick	लाथ मारना	Kicked	Kicked
Kidnap	अपहरण करना	Kidnaped	Kidnaped
Kill	मार देना	Killed	Killed
Knock	दरवाजा खटखटाना	Knocked	Knocked
laugh	हँसना	laughed	laughed
Learn	सीखना	Learned	Learned
Lend	उधार देना	Lent	Lent
Lick	चाटना	Licked	Licked
Lie	झूठ बोलना	Lied	Lied
Lift	ऊपर उठाना	Lifted	Lifted
Light	जलाना, प्रकाशित करना	Lighted	Lighted
Live	रहना	Lived	Lived
Locate	ढूंड निकालना	Located	Located
Look	देखना	Looked	Looked
Lose	खोना, हारना	Lost	lost
Love	प्यार करना	Loved	Loved
Maintain	संभालना, बनाए रखना	Maintained	Maintained
Marry	शादी करना	Married	Married
Melt	पिघलाना, गल जाना	Melted	Melted
Mention	उल्लेख करना	Mentioned	Mentioned
Mind	मन लगाना	Minded	Minded
Miss	चूकना	Missed	Missed
Move	हिलना	Moved	Moved
Murder	खून करना	Murdered	Murdered
Narrate	बयान करना	Narrated	Narrated
Need	जरुरत होना	Needed	Needed
Nominate	नामित करना	Nominated	Nominated
Note	लिख लेना	Noted	Noted
Notice	ध्यान देना	Noticed	Noticed
Nourish	पोषण करना	Nourished	Nourished
Oblige	एहसान करना, मजबूर करना	Obliged	Obliged
Observe	निरिक्षण करना	Observed	Observed
Obtain	पाना	Obtained	Obtained
Occur	घटना होनी होना	Occurred	Occurred
Open	खोलना	Opened	Opened
Pain	दर्द होना	Pained	Pained
Pardon	माफ़ करना	Pardoned	Pardoned
Paste	चिपकाना	Pasted	Pasted
Prefer	पसंद करना, चुनना	Preferred	Preferred
Prepare	तैयार करना	Prepared	Prepared
Produce	उत्पादन करना	Produced	Produced
Promise	वचन देना	Promised	Promised
Protect	रक्षा करना	Protected	Protected
Prove	सिद्ध करना	Proved	Proved
provide	उपलब्ध कराना	provided	provided
Publish	प्रकाशित करना	Published	Published
Pull	खीचना	Pulled	Pulled
Punish	सजा देना	Punished	Punished
Push	धकेलना	Pushed	Pushed
Quarrel	झगड़ना	Quarreled	Quarreled
Question	सवाल पूछना	Questioned	Questioned
Rain	बारिश गिरना	Rained	Rained
Raise	बढ़ाना	Raised	Raise
Reach	पहुचना	Reached	Reached
Realize	एहसास होना	Realized	Realized
Receive	स्वीकारना	Received	Received
Reconcile	मेल बिठाना	Reconciled	Reconciled
Rectify	सुधार करना	Rectified	Rectified
Reduce	कम करना	Reduced	Reduced
Refine	साफ़ करना	Refined	Refined
Reflect	प्रतिबिंब देखना	Reflected	Reflected
Refund	लौटाना	Refunded	Refunded
Refuse	नकारना	Refused	Refused
Regret	पछतावा करना	Regretted	Regretted
Reject	अस्वीकार करना	Rejected	Rejected
Relax	आराम करना	Relaxed	Relaxed
Remember	याद करना	Remembered	Remembered
Remind	याद दिलाना	Reminded	Reminded
Represent	प्रतिनिधित्व	Represented	Represented
Require	जरुरत होना	Required	Required
Reserve	आरक्षित रखना	Reserved	Reserved
Resign	इस्तीफा देना	Resigned	Resigned
Respect	आदर करना	Respected	Respected
Rest	आराम करना	Rested	Rested
Reveal	प्रकट करना	Revealed	Revealed
Revise	दोहराना	Revised	Revised
Roam	भटकना	Roamed	Roamed
Rob	चोरी करना	Robbed	Robbed
Rush	जल्दी करना, झपटना	Rushed	Rushed
Sacrifice	त्याग करना	Sacrificed	Sacrificed
Save	बचाना	Saved	Saved
Search	खोजना	Searched	Searched
Seem	अभास होना	Seemed	Seemed
Select	चुनना	Selected	Selected
Separate	अलग करना	Separated	Separated
Serve	परोसना	Served	Served
Settle	स्थिर होना	Settled	Settled
Share	हिस्सा देना	Shared	Shared
Shave	दाढ़ी करना	Shaved	Shaved
Shout	चिल्लाना	Shouted	Shouted
Sign	हस्ताक्षर करना	Signed	Signed
Smell	सूंघना	Smelled	Smelled
Solve	हल करना	Solved	Solved
Sow	बिज बोना	Sowed	Sowed
Spare	आधिकवस्तु रखना	Spared	Spared
Spend	खर्च करना	Spent	Spent
Stab	छुरा भोकना	Stabbed	Stabbed
Stare	एकटक देखना	Stared	Stared
Start	शुरुवात करना	Started	Started
State	कथन करना	Stated	Stated
Stay	रहना	Stayed	Stayed
Stick	चिपकाना	Sticked	Sticked
Stitch	सिलाई करना	Stitched	Stitched
Stop	रुकना	Stopped	Stopped
Study	पढाई करना	Studied	Studied
Submit	प्रस्तुत करना	Submitted	Submitted
Subscribe	सदस्य बनना	Subscribed	Subscribed
Succeed	सफल होना	Succeeded	Succeeded
Suffer	भुगतना	Suffered	Suffered
Suggest	सलाह देना	Suggested	Suggested
Supply	आपूर्ति करना	Supplied	Supplied
Support	आधार देना	Supported	Supported
Suppose	कल्पना करना	Supposed	Supposed
Surprise	चकित होना	Surprised	Surprised
Surrender	शरण  जाना	Surrendered	Surrendered
Survey	सर्वेक्षण करना	Surveyed	Surveyed
Sympathize	सहानुभति देना	Sympathized	Sympathized
Talk	बोलना	Talked	Talked
Tally	मिलाना	Tallied	Tallied
Taste	चखना	Tasted	Tasted
Thank	शुक्रिया अदा करना	Thanked	Thanked
Threaten	डरना	Threatened	Threatened
Tie	बांधना	Tied	Tied
Toil	मेहनत करना	Toiled	Toiled
Tolerate	सहन करना	Tolerated	Tolerated
Torture	सताना	Tortured	Tortured
Touch	स्पर्श करना	Touched	Touched
Trade	व्यापार करना	Traded	Traded
Transfer	तबादला करना	Transferred	Transferred
Translate	भाषांतर करना	Translated	Translated
Transport	परिवहन करना	Transported	Transported
Travel	सफ़र करना	Traveled	Traveled
Treat	इलाज करना	Treated	Treated
Trouble	तकलीफ देना	Troubled	Troubled
Trust	भरोसा रखना	Trusted	Trusted
Try	प्रयास करना	Tried	Tried
Turn	घुमाना	Turned	Turned
Use	इस्तेमाल करना	Used	Used
Utilize	उपयोग करना	Utilized	Utilized
Value	मूल्य लगाना	Valued	Valued
Verify	ध्यानपूर्वक देखना	Verified	Verified
Visit	भेंट देना	Visited	Visited
Vomit	उलटी करना	Vomited	Vomited
Wag	पूँछ हिलाना	Wagged	Wagged
Wait	इंतजार करना	Waited	Waited
Walk	चलना	Walked	Walked
Wander	भटकना	Wandered	Wandered
Want	जरुरत होना	Wanted	Wanted
warm	गरम होना	Warmed	Warmed
Warn	चेतावनी देना	Warned	Warned
Wash	साफ करना	Washed	Washed
Waste	ख़राब करना	Wasted	Wasted
Watch	नजर रखना	Watched	Watched
Whistle	सिटी बजाना	Whistled	Whistled
Wish	इच्छा जाहिर करना	Wished	Wished
Witness	गवाही देना	Witnessed	Witnessed
Wonder	आश्चर्य करना	Wondered	Wondered
Work	काम करना	Worked	Worked
Worry	चिंता करना	Worried	Worried
Yell	चिल्लाना	Yelled	Yelled
Yield	शरण आना	Yielded	Yielded
